Никитин Даниил Денисович: Ароматерапия
Соколов Ярослав Иванович: Астрология
Михайлова Варвара Марковна: Астрономия
Куликова Малика Львовна: Аэробика
Мартынова Василиса Матвеевна: Аэрография
Александров Борис Владиславович: Бадминтон
Федоров Демид Алексеевич: Батут
Маслова Виктория Яновна: Бег
Павлов Павел Семёнович: Бильярд
Щукина Вера Никитовна: Блоггерство
Селезнев Константин Владимирович: Боевые искусства
Шарапова Алина Леонидовна: Бонсай
Владимиров Тимур Семёнович: Боулинг
Исакова Анна Никитовна: Велосипед
Жданова Яна Александровна: Видеомонтаж
Мишин Егор Валерьевич: Выращивание кристаллов
Костина Виктория Игоревна: Выращивание растений и цветов
Третьякова Александра Антоновна: Вязание
Константинова Алёна Данииловна: Игра на органе
Аксенова Елизавета Ильинична: Наблюдение за насекомыми
Зыков Валентин Степанович: Офтальмология
Лихачев Юрий Эдуардович: Ролевые игры
Никифоров Степан Сергеевич: Сексология
Гурьев Севастьян Платонович: Тренинги
Устинов Тихон Геласьевич: Физическая электроника
Логинов Ипполит Созонович: Хирургическая онкология
Гордеев Панкрат Ростиславович: Эзотерика
Брагин Даниил Русланович: None
Федотов Наум Митрофанович: None
Поляков Юлий Протасьевич: None
